OOOOOOOOOOO
OOOOOSOXXXX
XXXXOEOOOOO
AXOOOOOOOOO
OOOOOOOOOOO