SOOOOOOOOOO
XXXXXOOOOXX
EXXXXXXOOOO
OOOOOXXOOOO
OOOOOOOOOOO
XXXXXXXOOOA